親字	旧字	異体字
㿉		㿗
䘌		𧏾
䧢		𨸟
一		弌
万	萬万	
丈		𠀋
三		弎
与	與	
丑		丒
世		卋丗
丘		坵㐀邱
両	兩	㒳
並	竝	並
丱		卝
丸		𠁽
久		镹乆
乗	乘	
乱	亂	
乾		乹
亀	龜	龜
予	予豫	
争	爭	
事		㕝叓亊
二		弍
于		亐亏
亜	亞	
亟		焏
亡		兦
亨		亯
京		亰
亭		𠅘
亮		𠅙
人		𠆢亻
今		𫝆仐
仏	佛	𠏹
仞		仭
以		㠯
仮	假	
会	會	㑹
伝	傳	
似		佀
佇		竚
体	體	軆躰
余	余餘	
作		做
佞		侫
佩		珮𬽳
併	倂	
佸		𠈲
使		𠉕
侃		偘𠈉
価	價	
侮	侮	
侯		𥎦矦
便		𠊳
俎		爼
俐		悧
俟		竢
俠		侠
俣		㑨
俱		倶
倅		伜
倆		𠈓
倍		俖
倏		焂倐
候		𠊱
倚		𠋣
倦		勌
倹	儉	
健		徤
偬		傯倊
偸		偷
偽	僞	
傑		杰
傘		𠍘
備		偹僃
傚		俲
傲		慠
僂		偻
僉		㑒
僊		僲
像		像
僕		䑑㒒
僧	僧	
僭		僣
儁		㒞
儐		𭀀
儔		𠍻俦
儕		㑪
儘		侭
儚		𠐧
儞		你
儻		傥
儼		𠑊
充	充	
兆		𠧞
光		炗灮
兌		兑兊
免	免	
兎		兔兔
児	兒	
兕		𤉡𧰽
兗		兖
党	黨	
兜		兠
全		㒰
兪		俞
冀		兾冀
冂		冋
内	內	
円	圓	圎
冉		冄
冊	册	𠕋𠕁
冏		囧
冒		冐
冗		宂冗
写	寫	𭂁冩
冢		𠣥
冤		寃
冥		㝠
冪		幂羃
冬	冬	
冱		𠖱
凄		淒
凜		澟𠘡凛
凡		凢
処	處	
凭		凴
凶		𣧑
函		圅凾
刀		釖
刃		刄
刈		𠛄苅
刊		刋
刑		㓝𠛬
刓		㝴
删		𠜂刪
別		𠛰
利		𥝤
刮		𠜜
刱		剙剏
刲		𠝥
刹		𠜽
剃		鬀
則		𠟭
剋		尅勊
前		歬偂
剔		𠜓
剛		㓻
剜		𠛠
剝		剥
剣	劍	𠝏釼剱劔劒
剤	劑	
剪		翦
剰	剩	
割	割	
創		𠟐戧刅
剿		劋𠞰
功		㓛
劫		刦刧
励	勵	
労	勞	
効	效	
勁		劤
勅	敕	
勇	勇	恿勈
勉	勉	
勖		勗
勢		㔟
勤	勤	
勧	勸	
勲	勳	勛
勺	勺	
勻		匀
匃		匄
匆		匇囱匆
化		𠤎
匝		迊帀
匯		滙
匳		籢奩匲
区	區	
医	醫医	毉
卅		𠦃
卉		芔卉
卑	卑	𤰞
卒		䘚卆
卓		桌
協		旪恊
単	單	𠦤
博		愽
卣		𠧪
卮		巵
卯		戼夘
即	卽	
却		㕁卻
卺		𢀾𧯢巹
卿		卿
厄		𢀴
厖		庬
厚		㫗
原		厡
厨		㕑廚
厩		廐廏
厭		猒
厲		厉
厳	嚴	
去		厺
参	參	
双	雙	
収	收	
叔		𠦑
叙	敍	敘
叟		叜
叡		睿
叢		藂樷
台	臺台	䑓
史		㕜
号	號	𭈹
吃		𠯏
吉		𠮷
同		仝
吝		㖁
吞		呑
吟		訡
吹		龡
吻		䐇脗
吽		呍
呉	吳	吴
告	吿	
周	周	
呪		咒
和		龢咊
咢		㖾
咤		咜吒
員		貟
哲		啠喆嚞悊
唇		脣
啀		嘊
啓		啔
啖		噉啗
啞		唖
善		譱
喉		㗋
喜		歖㐂
喝	喝	𡀽
喩		喻
喪		𠷔䘮
営	營	
嗅		齅
嗷		嗸
嘆	嘆	
嘑		謼
嘔		呕
嘗		𠹉甞
嘩		𠵅
嘯		嘨
嘱	囑	
嘷		嗥
噓		嘘
器	器	噐
噴	噴	
嚔		嚏
嚙		噛
囂		嚻
囊		嚢
回		囬囘
囟		顖
因		囙
団	團	
囲	圍	
図	圖	圗
国	國	囯囶圀
圏	圈	
園		薗
土		圡𡈽
圧	壓	
圭		珪
址		阯
坌		坋
坎		埳
坏		坯阫
坐		㘴
坑		阬
坼		𡍩
垂		埀
垓		畡
垛		垜
垠		𡋳
埋		薶
城	城	
埒		埓
埠		埗
埣		𡉻
執		秇
堆		𠂤
堕	墮	墯𡐦
堡		堢
堤		埞
堰		隁
場		塲
塀	塀	
塁	壘	
塍		畻𣎒堘
塚	塚	
塡		填
塩	鹽	𦣪
塹		壍𡐛
墁		㙢
墍		𡏲
増	增	
墨	墨	
墩		墪
墳	墳	
壅		㙲
壊	壞	
壌	壤	
壎		塤
壗		𡋤
壚		𡉴
壜		罎
壟		壠
壮	壯	
声	聲	
壱	壹	
売	賣	
壺		壷
変	變	
夐		𢿌
多		夛
夢		夣㝱梦
奇		竒
契	契	
奔	奔	𢍃
奘		弉
奥	奧	
奨	奬	㢡獎
妊		姙
妖		𡝩
妙		玅
妝		娤𡝂
妬		妒
姉		姊
姍		姗
姦		姧
姪		侄
姫	姬	姬
姮		嫦
姸		妍
姻		婣
娟		姢
娯	娛	
娿		妸婀
婚		㛰
婦		媍
婿		聟壻
媼		媪
嫂		㛮
嫉		㑵
嫩		媆嫰
嫫		𡠜
嫵		娬
嫺		𡢃嫻
嬢	孃	
嬲		娚嫐
嬾		嬾
子		㜽
学	學	斅斈
孶		孳
孺		𡦘
孼		孽
宅		㡯
宇		㝢𡧃
守		垨
安		𡚴
宜		冝宐
宝	寶	寳
実	實	
宿		㝛
寇		𡨥冦
富		冨
寓		庽
寛	寬	
寝	寢	
寧	寧	甯
寱		䆿
対	對	
寿	壽	
専	專	
将	將	
尚	尙	
尠		尟
尢		尣
尩		𡯪尪尫
尭	堯	
尻		㞍
尽	盡	𥁞
屁		𥧔
届	屆	
屎		𡱁
屛		屏
属	屬	
屢		屡
層	層	
屭		屓
岡		堽崗
岪		𡶒
岭		岺
岳	嶽	
岸		𡶜㟁
峡	峽	
峨		峩
峰		峯
島		隯隝陦嶹㠀嶌嶋
崎		陭㟢嵜﨑
崑		崐
崒		崪
崖		崕
崙		崘
崛		崫
嵆		嵇
嵌		篏
嵒		嵓
嵩		崧
嵬		㟴
嵯		嵳
嶃		嶄
嶢		嶤𡸳
嶧		𡵸
巌	巖	巗
川		巛
巣	巢	
左		㔫
巷		衖
巻	卷	
巽	巽	
帆		𩗋䑺㠶
希		𢁫
帑		伖
帚		菷
師		师
帯	帶	
帰	歸	皈
帽		冃㡌
幔		㡢
幕		幙
幣		幤
幫		帮幇
幬		𢃖
幮		㡡
年		秊
幵		开
幷		并
幸		𠂷
幹		榦
幺		么
幼		𢆲
庁	廳	廰
広	廣	
座		𫝷
庶		庻
廁		厠
廂		厢
廃	廢	
廈		厦
廉	廉	
廊	廊	
廛		㙻鄽壥
廝		厮
廟		庙庿
廠		厰
廨		𪠘
廩		廪㐭
廻		迴𢌞廽
廿		卄
弁	弁瓣辯辨	辧
弄		挵挊
弐	貳	貮
弑		弒
弛		㢮
弥	彌	㣆
弱		𢐅
強	强	
弼		𢐀弻
弾	彈	
彅		𦿶
彎		弯
彐		彑
当	當	
彙		彚
彝		彜
形		𢒈形
彦	彥	
彫	彫	
彬		斌
往		𢔎徃
征		𨒌
徂		䢐
径	徑	迳逕
徇		𢓈
徒		𨑒
従	從	从
得		𢔶㝵
徙		𨑭
御		𢕜
徭		傜
微		㣲
徳	德	𢛳悳
徴	徵	
忘		㤀
応	應	
忝		㤁
忽		𢗘
怕		𢗌
怖		悑
怙		𢛅
思		恖
急		㤂
怪		恠
怱		悤忩
恋	戀	
恐		𢙢
恒	恆	
恚		㜇㤬
恟		忷
恣		𢙊
恤		䘏卹
恥		耻
恨		𢙃
恪		愙㤩
恭		𢙄
恵	惠	僡
悄		𢖹
悋		恡
悔	悔	
悟		忢
悦	悅	恱
悩	惱	𢚰
悪	惡	
悱		㥱
悴		忰
悶		㥃
悽		恓
惇		惇
惕		悐
惛		惽
惝		𢠵
惨	慘	
惰		憜
惸		𢞛
愆		諐
愈		愈
愒		𢢚
愛		㤅
愜		㥦
愧		媿
愨		慤
慈	慈	㤵
慌		㤺
慍		愠
慎	愼	眘
慙		慚
慢		𢢔
慨	慨	
慷		忼
慼		慽
憁		愡
憂		𢝊
憊		𢟡
憎	憎	
憑		慿
憖		憗
憙		憘
憚		惮
憝		憞
憤	憤	
憩		憇
憫		𢡻
憯		㦧
憲	憲	
懇		𢡆
懈		𢢣
懊		㤇
懍		懔
懐	懷	
懕		㦔
懜		懵
懣		𢡛
懦		愞
懲	懲	
懶		懶
懺		懴
懼		愳
懿		㦤
戎		𢦦
成	成	
或		㦯
戛		戞
戟		𢧢
戦	戰	
截		𢧵
戯	戲	戱
戴		戴
戸	戶	户
戻	戾	
払	拂	
批		𢱧
扼		㧖搹
折		㪿
抜	拔	㧞
択	擇	
抽		𢭆
担	擔担	
拇		胟
拋		抛
拍		𢫦
拕		拖扡
拘		抅
拝	拜	
拠	據	㩀
拡	擴	㨯
拯		抍
拳		𢮙
拽		捙
拿		拏
指		𢫾
挙	擧	舉
挟	挾	
挿	插	揷
捐		捐
捜	搜	搜
捥		𢪸
掎		𢰤
掔		孯
掬		匊
掲	揭	
揄		𢶖
揶		捓
揺	搖	
搒		𢮔
搔		掻
搢		搢
搩		𢷡
搭		撘
携		𢹂㩗擕攜
摂	攝	
摑		掴
摻		撡
撃	擊	
撈		𢭐
撐		撑
播		𢿥
撼		㨔
撿		𢮦
擁		𢹬
擂		攂
擎		擏㢣
擡		抬
擣		搗𢭏
攢		攅
攪		撹
攫		爴
攬		㩜擥
攴		攵
敏	敏	
教	敎	
敢		𠭖
敦		㪟
数	數	𢿙
敲		搞㪣
整		𢿫
敵		𢿪
敷		旉𢾭
斉	齊	斊亝
斎	齋	斋
斑		辬
斟		酙
斥		㡿
斧		𨨞
断	斷	𣃔
斲		𠠇斵
於		扵
旁		㫄
旃		𣃼旜
旅	旅	
旆		斾
旒		㐬
旗		簱籏
旛		旙
既	旣	既
旧	舊	𦾔
旨		𠤔㫖
昂		昻
昃		𣅦
昇		曻
明		朙
昏		昬
星		皨曐
映		暎
春		萅旾
是		昰
昴		𣆻
昵		暱
昺		昞
昼	晝	
時		时旹
晃		晄
晋	晉	㬜
晒		曬
晟		晠
晢		晣
晩	晚	𣆶
普		暜
晰		晳
晴	晴	暒
晶		𣇵
暁	曉	
暄		煊
暑	暑	
暖		㬉
暦	曆	
暴		㬥
曄		曅
曠		昿
曦		㬢
曳		曵
更		㪅
曹		𣍘曺
曼		㬅
曽	曾	
替		㬱
最		㝡冣
朏		𣍧
朗	朗	朖
期		朞
朶		䒳朵
朽		𣏓
杆		桿
杉		杦
村		邨
杓		𣏐
条	條	
来	來	耒
杮		𣏕
杯		㮎桮盃
松		㮤梥柗枀枩
枕		𣏝
枡		桝
枢	樞	
枻		栧
柄		棅
柏		栢
柩		匛
柰		㮈
柳		栁桺
柵		栅柠
柺		枴
査		查
柿		柹
栃		𣜜杤
栄	榮	荣
栗		㮚
栟		栟
校		挍
栲		𣑥
栴		㮵
案		桉
桑		桒桒
桔		㮮
桜	櫻	
桟	棧	
梅	梅	坆槑栂楳
梓		榟杍
梔		栀
梨		棃
梱		棞
棄		弃
棋		棊
棬		椦
棲		栖
椁		槨
植		㯰
検	檢	
椰		㭨
椶		棕
楕		橢
楠		柟枏
楫		檝
楮		柠
楼	樓	
楽	樂	
楾		𤭯
概	槪	槩槪
榓		櫁樒
榴		橊
榼		𣖁
槁		槀
槃		柈
様	樣	
槙	槇	
槳		㯍
槵		梙
槶		椢
模		橅糢
権	權	
横	橫	
樸		檏
樹		𣗳
樽		罇墫
橈		𣓤
橋		𣘺槗
橌		橺
橐		槖
橛		橜
檃		櫽
檔		档
檗		蘗檘
檜		桧
檣		樯
檮		梼
檳		梹
櫟		檪
櫨		枦
櫱		蘖
櫳		㰍槞
櫺		欞
欄	欄	
欅		﨔
欒		栾
欖		㰖
欛		𣠽
欠	欠缺	𡙇缼
欧	歐	
欻		歘
款		欵㱁
歌		謌
歓	歡	
歔		歔
歩	步	
歯	齒	
歳	歲	
歴	歷	
歹		歺
歿		歾殁
殂		𣧫
残	殘	
殲		殱
殴	毆	
殺	殺	煞
殻	殼	㱿壳
毀		毁
毎	每	
毘		𣬈毗
毟		挘毮
氅		𪅶
氈		氊毡
氐		弖
気	氣	炁
氛		𣱦
氷		冰
汚		污洿汙
汴		汳
決		决
沃		𣵽
沈		沉
沖		冲
没	沒	
沢	澤	
沱		𣵺沲
沿		㳂沿
況		况况
泄		𣳘
泉		洤
法		㳒灋
泝		㴑
泥		埿
泰		㤗冭𣳾
洄		𭰁
津		𣸁
活		𣴠
流	流	㳅
浄	淨	净
浅	淺	
浙		淛
浜	濱浜	濵
浣		澣
浩	浩	澔
海	海	
浸		寖𣹦濅
浹		浃
涂		凃
涅		𣵀
涓		㳙
涙	淚	泪
涵		𣹢
涼		凉
淬		㳃
深		㴱
淳		湻
淵		渊渕
添		𣷹沗
清	淸	
渇	渴	
済	濟	
渉	涉	
渋	澁	澀
渓	溪	
渚	渚	
減		减
温	溫	
游		㳺
湾	灣	
湿	濕	溼
満	滿	
準		凖
溜		澑
溲		𣸈
滂		霶
滋	滋	𦱳
滎		濚
滔		㴞
滝	瀧	
滞	滯	
滲		渗涁
滾		滚
漆		㯃柒
漏		屚
漕		𤅍
漢	漢	
潑		溌
潔		洯
潜	潛	濳
潨		灇潀
潮	潮	
潸		澘
澄		澂
澗		礀㵎
濁		浊
濤		涛
濬		𣽊
濾		沪
瀆		涜
瀉		泻
瀏		嚠
瀞		瀞瀞
瀦		潴
瀬	瀨	
瀰		㳽
灌		潅
灑		𤂢
灝		𤂖
灞		㶚
灩		灔灎
灯	灯燈	
灰		𤆆
災		灾烖
炉	爐	
炯		烱
炱		炲
点	點	
為	爲	
烽		熢㷭
焚		燓
焰		熖㷔燄焔
焼	燒	
煙		𤇆烟
煢		㷀
煮	煮	煑
熏		燻
熙	煕	凞焈熈凞
熟		𤎼
熱		热
燮		爕
燼		㶳烬
爛		爤燗
爵	爵	𩰦𣝣
爺		𤕓
爾		尒尓
牆		墻
牖		牗
牢		窂
犂		犁
犠	犧	
犢		㸿
状	狀	
狉		豾
狗		㺃
独	獨	
狭	狹	
狸		貍
狻		䝜
猊		貎
猗		䝝
猟	獵	𤢪
猪	猪	䐗豬
猫		貓
献	獻	
猴		㺅
猶		犹
猿		𫞤猨
獄		𡈭
獏		貘
獠		䝤
獣	獸	
獮		𤣐
獲		𤟱
獺		㺚
玞		砆
玨		珏
珉		䃉瑉玟
珍		𤤽珎
班		𤤻
琅		瑯
琢	琢	
琴		琹珡
琺		珐
瑁		蝐
瑇		玳
瑠		璢
瑣		𤨏
瑰		瓌
瑶	瑤	
璃		瓈
璇		璿
瓊		琁
瓔		珱
瓚		瓉
瓦		𤬦
瓶	甁	缾缾
瓷		𦈱甆
瓺		𤭖
甌		瓯
甑		䰝
甕		罋
甜		甛
産	產	
甦		𤯳
町		甼
画	畫	畵𤰱
畀		畁
界		𨺬畍堺
畎		𤰝甽
留		畄畱
畚		𠫻
畝		畮畞畒畆𤰖㽗
略		畧
畬		畲畭
異	異	
畳	疊	疉疂
疆		疅壃畺
疇		畴
疎		踈
疏		䟽
疐		𤴡
疹		𤺋
痀		𤹪
痩	瘦	膄𤸃
痴	癡	
痾		疴
瘁		疩
瘞		𨻊
瘤		癅
瘻		瘘
癰		癕臃
発	發	
皁		皂梍
的		旳
皎		晈
皐		臯皋
皓		皜
皖		晥
皚		溰
皞		暭暤皥皡
皰		靤
皸		皹
盂		𥁄𥁄
益	益	
盍		盇
盎		㼜
盗	盜	
盛	盛	
盞		醆
盱		𥅚𥃳
相		𥄢
県	縣	
真	眞	
眥		眦
眼		𥆢
睥		睤
睨		𥆩
睹		覩
瞍		𥈟
瞏		睘
瞞		𥈞
瞠		瞪
瞯		𥊺
瞰		矙
瞼		𥇥
矚		瞩
矛		𨥨𢦧
矢		笶
矧		矤
矩		榘
矰		𢎒
砒		磇
研	硏	
砕	碎	
砧		碪
砰		硑
砲		礮
确		埆
碇		矴
碊		𥒎
碑	碑	
碕		𥔎
碗		盌
碩		碵
碯		瑙
確		碻
碾		𥑊
磁	𥔵	
磨		䃺
磽		墝
礦		砿
礪		砺
礼	禮	礼
社	社	
祀		禩
祈	祈	
祉	祉	
祐	祐	
祓		𥘬
祖	祖	
祝	祝	
神	神	
祥	祥	
票		𤐫
禄	祿	
禅	禪	
禍	禍	旤
禎	禎	
福	福	
禰		祢
禱		祷
秋		𪛁龝穐秌
秒		䅺
秕		粃
秘	祕	
秣		䬴
秭		𥝱
称	稱	穪
稈		秆
税	稅	
稚		穉稺
稟		禀
稲	稻	
稷		禝
稽		𥡴
稿		藳稾藁
穀	穀	糓
穂	穗	
穎		頴
穏	穩	
穣	穰	
穽		阱
突	突	
窃	竊	
窓		牕䆫窻窗
窪		漥
窮		竆
窯		窑窰
窺		闚
窿		㝫
竄		𮄒
竈		灶䆴𥧄竃
竜	龍	
竪		豎
端		耑
競		竸
竽		𥫡
笱		𦊒
筆		笔
筇		笻
筋		觔荕
筍		笋
筏		栰
筐		筺
筒		筩
筓		笄
策		萗
箋		䇳㮍牋
箏		筝
算		祘
箘		箟
箚		劄
節	節	
築		𥱋簗
篙		㰏
篝		𥵡
篠		筿筱
篡		簒
篤		䔍
篦		箆
篩		籭
篪		䶵箎
簋		𣪘
簏		箓
簞		箪
簠		㝬
簡	𥳑	
籅		𥫣
籌		筹
籐		籘
籒		籀
籔		䉤
籠		篭
籤		籖
籰		篗
粋	粹	
粘		黏
粛	肅	
粳		秔稉
粼		𥻘
粽		糉
精	精	
糂		糝
糍		𩝐
糕		餻
糖	糖	糛𥹥
糠		穅
糧		粮
糯		穤稬
糱		糵
糲		䊪
糴		籴
糶		粜
糸	糸絲	
糾		糺
紘		綋
紙		帋
紝		絍
紮		紥
累		絫纍
紲		緤絏
経	經	巠
絛		縧
絣		絣
絵	繪	
絶	絕	
継	繼	㡭
続	續	
綷		紣
綿		緜
緇		𱹼
総	總	揔摠緫
緑	綠	
緒	緖	
線		綫
緡		緍
緪		絚
練	練	
縁	緣	
縄	繩	
縉		縉
縕		緼
縦	縱	
縶		馽
繁	繁	
繈		繦
繊	纖	纎
織		𦀗
繡		綉繍
繫		繋
繭		蠒絸
纃		緕
纊		絖絋
纏		纒
纑		䋆
纓		䋝
纘		纉
纛		𢃶
纜		䌫
缶	缶罐	𦈢欟𣠤缻
罌		甖
罡		𦊆
罩		䈇
罪		辠
罰		罸
署	署	
羇		覉
羈		覊
羊		𦍌
羌		羗
羑		羐
羕		𣴎
群		羣
羹		羮
羽	羽	
翠		翆
翬		𦑩
翺		翱
翻		飜
翼		𦐂
者	者	
耇		耈
耋		耊
耕		畊
耗		秏
耙		䎱
耜		㭒
耨		槈
耼		聃
耽		躭
聒		𦕾
聞		𥹢
聡	聰	聦
聯		聨
聴	聽	
職		軄
肇		肈
肉		宍
肯		𣍟肎
肱		厷
育		毓
肴		餚
胄		伷
胆	膽	
胚		肧
胭		臙
胸		胷
脆		脃
脇		䏮𦚰
脈		衇脉
脚		腳
脛		𦙾
脱	脫	
脳	腦	匘
腁		胼
腕		𢯲
腥		胜
腰		𦝫
腸		膓
膀		髈
膚		肤
膝		厀
膩		𦡸𧸐
膳		饍
膾		鱠脍
臆		肊
臍		𦜝
臏		髕
臓	臟	
臘		臈﨟
臥		卧
臭	臭	
致	𦤶	
臾		㬰
臿		𦥛
舂		𣇃㫪
舃		𩍆𭴷舄
舎	舍	
舐		舓䑛
舗	舖	鋪
舞		儛
舵		䑨
船		舩
艪		艣
艫		舮
艮		𥃩
艱		囏
艶	艷	豔
艾		𦫿
芒		𥝕𦬆
芦		蘆蘆
花		蘤芲
芸	藝芸	秇蓺
芻		蒭
芽	芽	
苔		菭
苡		苢
若		若
英		偀
苺		莓
茎	莖	
茘		荔
茝		茝
茶		茶
荇		莕
荊		荆
荘	莊	㽵
荻		藡
莅		蒞
菉		菉
菊		蘜
菑		葘
菟		莵
菫		蓳
華	華	蕐
菰		苽
菱		菱
菴		葊
菹		葅
萊		莱
萌		萠
萍		蓱
萱		藼蕿蘐
萸		茰
萼		蕚
落	落	
葉		葉
著	著	
葬		塟
葱		蔥
蓄		稸
蓋		盖葢
蓑		簔簑
蓨		蓚
蓮	蓮	
蓼		蓼
蔕		蒂
蔘		薓
蔣		蒋
蔭		𨼲䕃𦹥
蔵	藏	
蕊		蘂蕋
蕩		蘯
蕭		䔥
薛		𧃎
薩		蕯
薫	薰	
薬	藥	
薺		萕
藍	藍	
藐		𧂀
藤		䕨
藪		薮
藺		藺
蘇		穌蘓
蘋		薲
蘭	蘭	
蘿		蘿
虎		乕
虚	虛	虗
虜	虜	
虫	蟲虫	䖝
虯		虬
虻		蝱
蚊		蟁蚉
蚋		蜹
蚌		蜯
蚓		螾
蚕	蠶	蝅
蚣		蜙
蛇		𧉮虵
蛍	螢	
蛔		蛕蚘
蛗		𧑉
蛙		鼃䵷
蛮	蠻	
蛾		䖸
蜂		蠭
蜃		蜄
蜈		𧋋
蜋		螂
蜮		𧌒
蜿		䖤
蝟		猬
蝥		蟊
蝨		虱
螭		彲
螻		蝼
蟇		蟆
蟒		蠎
蟬		蝉
蟹		蠏
蟻		螘
蠅		蝿
蠕		蝡
蠟		䗶蝋
蠣		蠇蛎
蠹		螙蠧
衄		衂
衆		眾
衛	衞	
衮		袞
衽		袵
袋		帒
袗		袮
袠		袟
袴		褲絝
袷		裌
袽		𦀌
装	裝	
裊		褭
裏		裡
裙		帬裠
裴		裶裵
裸		躶
褌		裩
褎		褏
褐	褐	
褒		襃
褓		緥
襄		㐮
襌		褝
襒		𧝬
襟		䘳
襤		繿
襪		韤韈
襷		𧜎
覆	覆	
覇		霸
規		䂓
覓		覔
視	視	眎眂
覚	覺	覐
覧	覽	
覰		覷
観	觀	
解		觧
觥		觵
触	觸	
觩		𤙠觓
觶		觗
觿		觽
記		𧪄
訛		譌
訳	譯	
診		𧦜
証	証證	
訾		訿
詆		呧
詠		咏
詬		訽
話		䛡
誉	譽	
説	說	
読	讀	
誼		𧧼
諂		讇
諛		䛕
諤		讍
諭	諭	
諱		𮘪
諸	諸	
謁	謁	
謡	謠	
謨		𢜯
謫		讁
謳		𧦅
謷		謸
謹	謹	
譖		譛
譲	讓	
譾		謭
讃		讚
讌		醼
讐		讎
讒		䜛
讕		譋
讖		䜟
谹		𧮯
谺		岈
谿		磎𧮾
豅		𧯇
豊	豐	
豌		𧯡
豚		㹠豘
象		𧰼
豣		猏𧱚
豭		猳
豺		犲
豻		犴
貂		鼦
貉		狢
貊		貃
貌		㒵皃䫉
貔		豼
貝		蛽
財		戝
貴		䝿
賓	賓	賔
賖		賒
賚		𧶛
賛	贊	
賢		贒
賤		賎
質		貭
賺		𧸖
賾		𧷤
贈	贈	
贋		贗
贍		𩟋
贐		賮
贓		賍
赫		爀
赬		頳䞓
走		𧺆赱
趁		趂
趑		䠖趦
跋		䟦
跖		蹠
跬		蹞䞨
践	踐	
踊		踴
踧		𨀚
踪		蹤𨌰
蹄		蹏
蹈		𨂻
蹋		蹹
蹕		𠌫
蹯		籵
蹴		蹵
蹶		蹷
躁		趮
躄		躃
躇		墸䠧
躊		踌
躔		𨇠
躙		蹸躪
躚		蹮
躬		躳
軀		躯
軌		䡄
軍		𠣞
軛		軶
軟		輭
転	轉	
軫		𨋏
軽	輕	
輒		輙
輛		輌
輜		輺
輩		軰
輸	輸	
輿		轝
轄		鎋
轜		輀
轟		軣
轤		䡎
辛		𨐌
辞	辭	辤
辺	邊	邉
迤		迆
迥		䢛逈
迪		廸
迫		廹
迺		廼
逃		迯
逆		屰
逓	遞	
逖		逷
這		这
通		𢓶
連	連	
逬		迸
逸	逸	
遅	遲	遟
遍		徧
過		过
遒		逎
道		衟
達		达逹
違		𨑕
遥	遙	
遷		迁
選		𨕖
遼	遼	
邃		𨗉
還		还
邅		𧾍
邇		迩
邈		𨘷
邛		卭
邢		郉
那		𨙻
郎	郞	
郤		郄
部		郶
郰		鄹
郷	鄕	
都	都	
鄖		䢵
酆		鄷
酔	醉	
酗		䣱
酢		醋
酬		醻酧
醇		醕䣩
醜		魗
醬		醤
醱		醗
醸	釀	
醾		釄
釈	釋	
野		𡌛㙒壄埜
釜		釡
釤		𨥆
釬		銲
鉄	鐵	鐡銕
鉈		鉇
鉚		𨥫
鉛		鈆
鉢		缽盋𥁊
鉤		鈎
鉱	鑛	磺
鉼		鉼
銜		衘㘅啣
銭	錢	
銹		鏽鏥
鋏		𨦇
鋒		鏠
鋭	銳	𨦣
鋳	鑄	
錬	鍊	
録	錄	
鍐		鑁
鍬		鍫
鎌		鐮
鎖		鏁鎻
鎮	鎭	
鏖		䥝
鏘		𨪙
鏝		𨭜
鏞		銿
鏟		𨩱
鏤		𨩐
鏨		鏩
鏸		𨫍
鐫		鎸
鐸		鈬
鑑		鑒鍳
鑓		𨯯
鑣		䮽
鑪		鈩
鑵		𨫝
鑽		鑚
長		镸
閉		閇
閏		閠
間	閒	
関	關	
閲	閱	
閻		閆
闃		閴
闊		𤄃濶
闘	鬪	鬭
阤		陁
阨		阸
陋		𨹟
降	降	夅
陛		㙄
陟		徏
陥	陷	
陰		隂阴
険	險	𡸴嶮
陽		阳
隆	隆	
階		堦
随	隨	
隙		𨻶
隠	隱	乚
隣		鄰
隴		𨻫
隷	隸	
隺		寉
雁		鴈鳫
雄		䧺
集		𠍱亼雧
雋		隽
雌		䳄
雍		雝
雑	雜	襍
雕		鵰
雖		𨿽
雛		鶵
難	難	
雪		䨮
雷		靁
霊	靈	㚑灵䨩
霢		霡
靊		霻
青	靑	
靖	靖	竫
静	靜	
面		靣
靱		靭韌
靴		鞾
鞋		鞵
鞍		鞌
鞘		韒
鞠		毱
鞫		𥷚
鞹		鞟
韊		䪍
韘		弽
韜		鞱
韝		鞲
韠		鞸
韭		韮
韻		韵
響	響	
頤		頥𦣝
頰		頬
頸		頚
頻	頻	
頼	賴	
頽		頺頹
顋		腮
顔	顏	
顕	顯	
顚		顛
類	類	
風		飌凬凮
飄		飃
飆		颷飈飇
食		𠊊飠
飧		飡飱
飯	飯	飰
飲	飮	㱃
飼	飼	飤
飾		餝
餅		餠
餉		饟𩜋
養		养
餐		湌
餞		䬻
館	館	舘
餬		𩚩
餱		糇
餴		饙
饅		𪍩
饌		䉵
饎		糦
饒		𩜙
饘		飦
馘		聝
駄		馱
駅	驛	
駆	驅	敺駈
駝		駞
駻		馯
騈		駢
騎		𮪍
騒	騷	
験	驗	騐
騭		隲
騾		𩦻驘
驁		䮯
驑		騮
驒		騨
驢		馿
髄	髓	膸
高		髙
髡		髨髠
髥		髯
髪	髮	
髭		頾
鬢		髩鬂
鬣		㲱
鬧		閙
鬮		䦰䰗
鬱		欝𣡸
鬲		䰛
魂		䰟
魅		鬽
魚		𩵋
鮑		蚫
鮒		𩷺
鮨		䱈
鮾		鯘
鯊		魦鯋
鰌		鰍
鰐		鱷
鰥		𩻄
鰮		鰛
鰺		鯵
鱪		鱰
鱭		鮆
鱶		鯗
鱸		魲
鳧		鳬
鴃		鴂
鴉		鵶𩿎
鴝		鸜
鴟		𨾦鵄
鴥		鴪
鵙		鶪
鵝		鵞
鵡		䳇
鵪		䨄
鵲		䧿
鶉		𨿡
鶏	鷄	𨿸雞
鶤		鵾
鶯		鸎鴬
鶴		靏靎靍鶴
鶺		𪃹
鷀		鶿
鷆		鷏
鷗		鴎
鸛		雚
鹹		醎
鹼		鹻鹸
鹿		𢈘
麇		麕
麗		䴡
麞		獐
麤		麁
麦	麥	
麩		麬麸
麰		𪍓
麳		𪎌
麴		麯麹
麺	麵	麪
麻		蔴
麼		麽
黄	黃	
黒	黑	
黙	默	
黛		黱
鼇		鰲
鼈		鱉
鼎		𣇄𪔂
鼓		皷
鼖		䩿𪔵
鼠		鼡
鼴		鼹
齏		䪡虀韲
齔		齓
齟		𪗱
齢	齡	
齧		囓𪘂
齬		𪘚
齶		腭
蘒		蘒
𠂣		㐆
𠮟		叱
𡑭		𡋗
𡖂		虁夔
𡣍		𡢔嬴
𥸤		龥
𨫤		𨯁
𩅸		霤
𩞷		餾
枅		枅
濆		濆
莽		莽
賁		賁
