親字	旧字	異体字
万	萬	
与	與	
両	兩	
並	竝	
乗	乘	
乱	亂	
亀	龜	
予	豫	予
争	爭	
亜	亞	
仏	佛	
仞		仭
仮	假	
会	會	
伝	傳	
体	體	
余	餘	余
併	倂	
価	價	
侮	侮	
俠		侠
俱		倶
倅		伜
倹	儉	
偽	僞	
僧	僧	
僭		僣
充	充	
免	免	
兎		兔兔
児	兒	
党	黨	
内	內	
円	圓	
冊	册	
写	寫	
冤		寃
凜		凛
処	處	
函		凾
刱		剏
剝		剥
剣	劍	
剤	劑	
剰	剩	
割	割	
剿		𠞰
励	勵	
労	勞	
効	效	
勅	敕	
勉	勉	
勖		勗
勤	勤	
勧	勸	
勲	勳	
匝		帀
区	區	
医	醫	
卅		丗
卉		卉
卑	卑	
単	單	
卮		巵
即	卽	
却		卻
卿		卿
厨		廚
厩		廐廏
厳	嚴	
参	參	
双	雙	
収	收	
叙	敍	
台	臺	
号	號	
吞		呑
周	周	
呪		咒
啖		啗
啞		唖
喝	喝	
営	營	
嘆	嘆	
嘱	囑	
噓		嘘
器	器	
噴	噴	
嚔		嚏
嚙		噛
囊		嚢
団	團	
囲	圍	
図	圖	
国	國	圀
圏	圈	
圧	壓	
坎		埳
城	城	
堕	墮	
塀	塀	
塁	壘	
塚	塚	
塡		填
塩	鹽	
増	增	
墨	墨	
墳	墳	
壊	壞	
壌	壤	
壮	壯	
声	聲	
壱	壹	
売	賣	
壺		壷
変	變	
契	契	
奔	奔	
奘		弉
奥	奧	
奨	奬	
姫	姬	
姮		嫦
姸		妍
婿	壻	聟
嬢	孃	
学	學	
孶		孳
孼		孽
宝	寶	
実	實	
寇		冦
寛	寬	
寝	寢	
対	對	
寿	壽	
専	專	
将	將	
尚	尙	
尭	堯	
尽	盡	
届	屆	
屛		屏
属	屬	
屢		屡
層	層	
屭		屓
岡		堽
岳	嶽	
峡	峽	
峨		峩
崖		崕
崙		崘
嵯		嵳
巌	巖	
巣	巢	
巻	卷	
巽	巽	
帯	帶	
帰	歸	
幫		幇
幷		并
庁	廳	
広	廣	
廁		厠
廃	廢	
廈		厦
廉	廉	
廊	廊	
廛		壥
廝		厮
廠		厰
弁	辨辯瓣	弁
弐	貳	
弥	彌	
弾	彈	
彎		弯
当	當	
彝		彜
彦	彥	
径	徑	
従	從	
徳	德	
徴	徵	
応	應	
怱		悤
恋	戀	
恒	恆	
恤		卹
恵	惠	
悔	悔	
悦	悅	
悩	惱	
悪	惡	
悴		忰
惨	慘	
愈		愈
慎	愼	
慙		慚
慨	慨	
憎	憎	
憤	憤	
懐	懷	
懲	懲	
懺		懴
成	成	
戛		戞
戦	戰	
戯	戲	
戸	戶	
戻	戾	
払	拂	
抜	拔	
択	擇	
担	擔	
拋		抛
拝	拜	
拠	據	
拡	擴	
拿		拏
挙	擧	
挟	挾	
挿	插	
捜	搜	
掲	揭	
揶		捓
揺	搖	
搔		掻
摂	攝	
摑		掴
撃	擊	
擡		抬
攢		攅
攪		撹
敏	敏	
教	敎	
数	數	
斉	齊	
斎	齋	
断	斷	
既	既旣	
旧	舊	
昼	晝	
晋	晉	
晢		晣
晩	晚	
晰		晳
晴	晴	
暁	曉	
暑	暑	
暦	曆	
曠		昿
曽	曾	
朗	朗	
杆		桿
条	條	
来	來	
枡		桝
枢	樞	
栄	榮	
桜	櫻	
桟	棧	
梅	梅	
棋		棊
棕		椶
検	檢	
楕		橢
楼	樓	
楽	樂	
概	槪槪	
槔		槹
様	樣	
槙	槇	
樒		櫁
権	權	
横	橫	
檗		蘗
檜		桧
檮		梼
櫟		檪
櫱		蘖
欄	欄	
欠	缺	欠
欧	歐	
歌		謌
歓	歡	
歩	步	
歯	齒	
歴	歷	
残	殘	
殲		殱
殴	毆	
殺	殺	
殻	殼	
毎	每	
気	氣	
没	沒	
沢	澤	
浄	淨	
浅	淺	
浜	濱	
海	海	
涙	淚	
淵		渕
清	淸	
渇	渴	
済	濟	
渉	涉	
渋	澁	
渓	溪	
渚	渚	
温	溫	
湾	灣	
湿	濕	
満	滿	
滝	瀧	
滞	滯	
漢	漢	
潑		溌
潜	潛	
澄		澂
澗		㵎
濤		涛
濾		沪
瀆		涜
瀞		瀞
瀦		潴
瀬	瀨	
灌		潅
灯	燈	
炉	爐	
炯		烱
点	點	
為	爲	
焰		焔
焼	燒	
煙		烟
煮	煮	
熔		鎔
熙		熈煕
燻		熏
爵	爵	
牆		墻
犂		犁
犠	犧	
状	狀	
独	獨	
狭	狹	
猟	獵	
猪	猪	
献	獻	
獣	獸	
琅		瑯
琢	琢	
瑇		瑇玳
瑠		璢
瑶	瑤	
瓶	甁	
産	產	
画	畫	
畬		畭
異	異	
畳	疊	
疇		畴
痩	瘦	
痴	癡	
発	發	
皐		皋
皹		皸
益	益	
盗	盜	
盛	盛	
盪		蘯
県	縣	
真	眞	
眥		眦
研	硏	
砕	碎	
碑	碑	
碗		盌
礦		砿
礪		砺
礼	禮	
社	社	
祈	祈	
祉	祉	
祐	祐	
祖	祖	
祝	祝	
神	神	
祥	祥	
禄	祿	
禅	禪	
禍	禍	
禎	禎	
福	福	
禰		祢
禱		祷
秕		粃
秘	祕	
称	稱	
税	稅	
稟		禀
稲	稻	
稽		𥡴
穀	穀	
穂	穗	
穎		頴
穏	穩	
穣	穰	
突	突	
窃	竊	
窓	窗	
竈		竃
竜	龍	
竪		豎
筍		笋
筐		筺
筓		笄
箏		筝
箚		劄
節	節	
篡		簒
篦		箆
簑		簔
簞		箪
籒		籀
籠		篭
籤		籖
粋	粹	
粘		黏
粛	肅	
精	精	
糸	絲	
経	經	
絣		絣
絵	繪	
継	繼	
続	續	
総	總	
緑	綠	
緒	緖	
練	練	
縁	緣	
縄	繩	
縦	縱	
繁	繁	
繈		繦
繊	纖	
繡		繍
繫		繋
纏		纒
纘		纉
缶	罐	鑵缶
署	署	
羽	羽	
翠		翆
翻		飜
者	者	
聡	聰	
聯		聨
聴	聽	
胆	膽	
脱	脫	
脳	腦	
腁		胼
膣		腟
臓	臟	
臭	臭	
致	𦤶	
舎	舍	
舗	舖	
艶	艷	
芸	藝	
芻		蒭
芽	芽	
苺		莓
茎	莖	
荊		荆
荘	莊	
菟		莵
華	華	
萊		莱
萌		萠
著	著	
蓋		葢
蓮	蓮	
蔕		蒂
蔣		蒋
蔵	藏	
蕊		蕋蘂
薫	薰	
薬	藥	
藪		薮
蘆		芦
蘭	蘭	
虚	虛	
虜	虜	
虫	蟲	
虻		蝱
蚕	蠶	
蛍	螢	
蛮	蠻	
蜹		蚋
蝨		虱
螂		蜋
蟇		蟆
蟒		蠎
蟬		蝉
蟹		蠏
蠅		蝿
蠟		蝋
蠣		蛎
蠹		蠧
衛	衞	
衮		袞
袵		衽
装	裝	
褐	褐	
褒	襃	
襌		褝
覇		霸
視	視	
覚	覺	
覧	覽	
観	觀	
触	觸	
訳	譯	
証	證	
誉	譽	
読	讀	
諡		謚
諫		諌
諭	諭	
諸	諸	
謁	謁	
謡	謠	
謹	謹	
譖		譛
譲	讓	
讃		讚
讐		讎
豊	豐	
賓	賓	
賛	贊	
賤		賎
贈	贈	
践	踐	
躄		躃
躪		躙
軀		躯
転	轉	
軽	輕	
輀		轜
輒		輙
輛		輌
輸	輸	
辞	辭	
辺	邊	
迪		廸
迺		廼
逓	遞	
連	連	
逬		迸
逸	逸	
遅	遲	
遒		逎
遡		溯
遥	遙	
遼	遼	
郎	郞	
郷	鄕	
都	都	
酔	醉	
醬		醤
醱		醗
醸	釀	
釈	釋	
野		埜
鉄	鐵	
鉤		鈎
鉱	鑛	
銭	錢	
鋭	銳	
鋳	鑄	
錬	鍊	
録	錄	
鎮	鎭	
鑑		鑒
鑽		鑚
関	關	
闊		濶
闘	鬪	鬭
降	降	
陥	陷	
険	險	
隆	隆	
随	隨	
隙		𨻶
隠	隱	
隣	鄰	
隷	隸	
雁		鴈
雑	雜	襍
難	難	
霊	靈	
青	靑	
靖	靖	
静	靜	
靱		靭
韮		韭
韻		韵
響	響	
頰		頬
頸		頚
頻	頻	
頼	賴	
頽		頹
顔	顏	
顕	顯	
顚		顛
類	類	
飯	飯	
飲	飮	
飼	飼	
餅	餠	
館	館	
駅	驛	
駆	驅	
騈		駢
騒	騷	
験	驗	
驒		騨
髄	髓	
髥		髯
髪	髮	
鬧		閙
鬱		欝
鰮		鰛
鰺		鯵
鳧		鳬
鴃		鴂
鴥		鴪
鵝		鵞
鶏	鷄	
鶪		鵙
鶯		鴬
鷗		鴎
鹼		鹸
麕		麇
麤		麁
麦	麥	
麩		麸
麴		麹
麺	麵	麪
黄	黃	
黒	黑	
黙	默	
鼴		鼹
齏		韲
齢	齡	
齧		囓
龝		穐
﨟		臈
枅		枅
濆		濆
莽		莽
賁		賁
